Level Two
.............
.............
.............
.............
.............
..112222111..
..101232101..
..101232101..
..111222111..
..101010101..
.............
.............
......B......
.............
.............
.............
.............
.............
.............
.............
.............
.....P.......
.............