Level Three
..............
..............
..............
..............
..............
..0001111000..
..0001111000..
..1113333111..
..1113333111..
..0001111000..
..0001111000..
..............
..............
.....B........
..............
..............
..............
..............
..............
..............
..............
......P.......
..............