Level Three
XXXXXXXXXXXXXXXXXXXX
XP.......E.........X
XXXXXXXXXXXXXXXXXXKX
X........H.........X
XDXXXXXXXXXXXXXXXXXX
X..................X
XXXDXXXXXDXXXX..XXDX
X.....X.....X....XEX
X.C.C.X..K..X.KH.XGX
XXXXXXXXXXXXXXXXXXXX