Level One
....................
.......C............
.....CCC............
...122223....C......
.PCC............EI.G
..CC.CIICC13....1XXX
..CC.CIIC.46........
.....CCI.156.1......
.....C..1556.1X.....
XXXX3..15556.1XXXXXX
