Level Two
....................
....................
......G.............
.P...1X23...E.......
...........12223....
...C................
..CC......13........
.........156.1......
..13...1X556.43.....
XXXXXXX55556.45XXXXX